2 2 5 5 3 1 5 4 3
5 0 5 3 4 3 1 0 5
1 5 4 3 5 3 2 0 5
5 3 3 5 0 5 1 5 1
2 1 4 3 4 4 5 2 1
1 3 2 4 0 0 3 4 0
1 4 1 4 5 0 2 0 5
0 2 0 5 2 3 4 1 3
5 4 1 3 1 4 5 2 0
r 30
b 5 25
s 0