2 2 5 5 3 4 5 4 3
5 0 / 3 4 3 1 0 5
4 5 4 3 5 3 2 0 /
5 3 * 5 3 5 1 5 2
2 1 * 3 4 / 5 2 *
1 3 3 4 0 0 3 4 *
1 / 3 4 5 0 2 0 1
0 2 0 5 2 3 4 1 1
5 / 1 3 / 4 5 2 0